1,1,1,1,1,1,1,1
1,0,0,0,0,0,0,1
1,0,0,0,0,0,0,1
1,0,0,0,0,0,0,1
1,0,0,0,0,0,0,1
1,0,0,0,0,0,0,1
1,0,0,0,0,0,0,1
1,0,0,0,0,0,0,1
1,0,0,0,0,0,0,1
1,0,0,0,0,0,0,1
1,0,0,0,0,0,0,1
1,0,0,0,0,0,0,1
1,0,0,0,0,0,0,1
1,0,0,0,0,0,0,1
1,0,0,0,0,0,0,1
1,1,1,0,0,1,1,1
1,0,0,0,0,0,0,1
1,22,0,0,0,0,8,1
1,0,0,0,0,0,0,1
1,6,0,0,0,0,12,1
1,0,0,0,0,0,0,1
1,10,0,0,0,0,16,1
1,0,0,0,0,0,0,1
1,14,0,0,0,0,20,1
1,0,0,0,0,0,0,1
1,18,0,0,0,0,8,1
1,0,0,0,0,0,0,1
1,22,0,0,0,0,12,1
1,0,0,0,0,0,0,1
1,0,0,25,29,0,0,1
1,1,1,1,1,1,1,1
